C 137,250,250
F 30,250,200
NO ./xpm/no.xpm
SO ./xpm/so.xpm
WE ./xpm/so.xpm
EA ./xpm/so.xpm


11111
10001
10N01
11111