C   137,250,255
NO ./xpm/no.xpm
SO ./xpm/so.xpm
WE ./xpm/we.xpm
F 30,250,0 
EA ./xpm/ea.xpm
					111
                1001
						1001                
                10W1
                111111