C                  137 4,250,250
F 3 0,250 , 200

NO ./xpm/no.xpm
SO ./xpm/so.xpm
WE ./xpm/so.xpm
EA ./xpm/so.xpm



111
101
1111111
11011W1
111111