C 137,250,250
F 30,250,200
NO ./xpm/no.xpm
SO ./xpm/so.xpm
WE ./xpm/so.xpm
EA ./xpm/so.xpm


111111111111111111111111111111
111111111110000000011000000001
100000000110000000011000000001
100000000110000000011000000001
100011000110000000011000000001
100000000110000000011000000001
10000N000110000000011000000001
100000000110000000011000000001
111111111110000000011000000001
111111111111111111111111111111