NO ./xpm/no.xpm
SO ./xpm/so.xpm
WE ./xpm/we.xpm
EA ./xpm/ea.xpm

F 62,63,64
C 33,41,128

1111111111111111111111111
1001001000110000000000001
1010000001110000000000001
1001000000000000000000001
1111111110110000011100001
1000000000110000011101111
1111011111111101110000001
1111011111111101110101001
1100000110101011100000001
1100000110101011100000001
1100000110101011100000001
1100000110101011100000001
1100000110101011100000001
1100000110101011100000001
1100000110101011100000001
1100000110101011100000001
1100000110101011100000001
1100000110101011100000001
1100000110101011100000001
1100000110101011100000001
1100000110101011100000001
1100000110101011100000001
1000000000000000110000001
1000000000000000110101001
11000N0111010101111101111
1111011111101011011110101
1111111111111111111111111