NO ./xpm/no.xpm
SO ./xpm/so.xpm
WE ./xpm/we.xpm
EA ./xpm/ea.xpm

F 220,100,0
C 225,30,0

1111111111111111111111111
1010101010101010101010101
110101010101111111010101111111
10101010101011010101010001
1101010101011111110101N1111111
1111111111111111111111111