NO ./xpm/no.xpm
SO ./xpm/so.xpm
WE ./xpm/we.xpm
EA ./xpm/ea.xpm

F 220,100,0
C 225,30,0

	1111111111111111111111111
	1000000000000000000000001
	1000000000000000000001111
11111111111111111111111111
111111110000000000000011111111
	111000000000000000000000000111111
	1000000000000000000000001N1111111
	1111111111111111111111111111